essay_id,organization,vocabulary,style,development,mechanics,structure,relevance,final_score,total_score
1,3,3,2,3,3,1,0,15,15
3,3,3,3,3,3,2,2,19,19
4,3,4,3,3,3,3,0,19,19
5,3,3,3,2,3,3,1,18,18
6,3,3,3,3,3,1,1,17,17
7,3,4,3,3,3,3,0,19,19
8,3,3,3,3,3,3,0,18,18
9,2,3,3,3,2,1,0,14,14
10,3,4,3,3,3,3,1,20,20
11,3,3,2,1,2,2,0,13,13
12,3,4,3,3,3,3,0,19,19
13,3,3,3,3,3,2,1,18,18
14,3,3,3,3,3,3,0,18,18
15,3,3,3,3,3,3,0,18,18
16,3,3,3,3,3,2,1,18,18
17,3,3,3,3,3,2,1,18,18
18,3,3,3,3,3,3,1,19,19
19,3,4,3,3,3,3,0,19,19
20,3,4,3,3,3,3,1,20,20
21,3,3,3,3,3,1,1,17,17
22,3,3,3,2,3,3,0,17,17
23,2,3,3,3,3,2,1,17,17
24,3,4,3,3,3,3,0,19,19
25,3,3,3,3,3,3,2,20,20
26,3,4,3,3,3,3,0,19,19
27,3,3,3,3,3,2,2,19,19
28,3,3,3,3,3,2,1,18,18
29,3,3,3,3,3,2,1,18,18
31,1,4,3,3,3,3,0,17,17
32,3,3,3,3,3,2,2,19,19
33,3,3,3,3,3,3,1,19,19
34,3,4,3,3,3,3,0,19,19
35,3,3,2,3,2,1,1,15,15
36,3,3,2,3,3,1,1,16,16
37,3,3,3,3,3,2,1,18,18
38,2,2,2,2,2,2,1,13,13
39,3,3,3,2,3,3,1,18,18
40,3,3,3,3,3,3,0,18,18
41,3,3,3,3,3,2,2,19,19
42,3,4,3,3,3,3,0,19,19
43,3,3,3,3,3,3,1,19,19
44,3,3,3,3,3,3,1,19,19
45,3,3,3,3,3,2,1,18,18
47,3,3,3,3,3,3,2,20,20
48,3,3,3,3,3,3,0,18,18
49,3,3,3,3,3,2,1,18,18
50,3,4,3,3,3,3,0,19,19
51,3,3,3,3,3,3,1,19,19
52,3,3,3,3,3,3,1,19,19
53,3,4,3,3,3,3,1,20,20
54,3,4,3,3,3,3,0,19,19
55,3,3,3,3,3,3,1,19,19
56,3,3,2,3,3,2,2,18,18
57,3,3,3,3,3,3,1,19,19
58,3,4,3,2,3,3,0,18,18
59,3,4,3,3,3,3,1,20,20
60,3,3,3,3,3,3,1,19,19
61,3,3,2,2,3,1,1,15,15
63,2,3,3,3,3,3,1,18,18
64,3,3,3,3,3,2,2,19,19
65,3,3,3,3,3,3,0,18,18
66,3,4,3,3,3,3,0,19,19
68,3,3,3,3,3,3,2,20,20
69,3,3,3,3,3,3,1,19,19
70,3,4,3,3,3,3,0,19,19
71,3,3,3,3,3,3,0,18,18
72,3,3,3,3,3,2,2,19,19
73,3,3,3,3,3,3,1,19,19
74,3,3,3,2,3,2,1,17,17
75,2,3,3,2,2,2,0,14,14
76,3,3,3,3,3,3,1,19,19
77,3,3,2,3,3,2,1,17,17
78,2,3,3,2,3,3,0,16,16
79,3,3,3,3,3,1,1,17,17
80,3,3,3,3,3,2,1,18,18
81,3,4,3,3,4,3,1,21,21
82,3,3,3,3,3,2,1,18,18
83,1,3,2,2,2,1,2,13,13
84,3,3,3,3,3,3,1,19,19
86,3,4,3,3,3,3,0,19,19
87,3,3,3,3,3,2,1,18,18
88,3,3,3,3,3,3,1,19,19
89,3,3,3,3,3,2,1,18,18
90,2,3,2,3,3,2,1,16,16
91,3,3,3,3,3,2,1,18,18
92,3,4,3,3,3,3,2,21,21
93,3,3,2,3,3,1,1,16,16
94,3,3,3,3,3,3,1,19,19
95,3,3,3,3,3,3,2,20,20
96,3,4,3,3,3,3,1,20,20
97,1,3,1,1,2,1,1,10,10
99,3,3,3,3,3,3,1,19,19
100,3,3,3,3,3,2,1,18,18
101,3,3,3,3,3,2,1,18,18
102,3,4,3,3,3,3,1,20,20
103,3,4,3,3,3,3,0,19,19
104,3,3,3,2,3,3,0,17,17
105,3,3,3,3,3,3,1,19,19
106,3,3,3,3,3,2,2,19,19
107,3,3,3,3,3,3,1,19,19
108,3,3,3,3,3,3,1,19,19
109,3,3,3,3,3,2,1,18,18
110,4,5,4,3,3,3,0,22,22
111,3,3,3,3,3,2,1,18,18
112,3,4,3,3,3,3,1,20,20
113,3,4,3,3,3,3,0,19,19
115,3,3,3,3,3,2,2,19,19
116,3,3,3,3,3,3,0,18,18
117,3,3,3,3,3,3,1,19,19
118,2,3,2,3,3,2,2,17,17
119,3,3,3,3,3,3,2,20,20
120,3,3,3,3,3,2,2,19,19
121,2,3,3,3,3,2,1,17,17
122,3,3,3,3,3,3,1,19,19
124,3,3,3,3,3,3,1,19,19
125,3,3,3,3,3,2,2,19,19
126,3,4,3,3,3,3,1,20,20
127,3,3,3,3,3,2,2,19,19
128,3,3,3,3,3,3,2,20,20
130,2,3,2,3,3,2,1,16,16
131,2,3,2,3,3,2,1,16,16
132,3,3,3,3,3,2,1,18,18
133,3,3,3,3,3,2,1,18,18
134,3,3,3,3,3,2,1,18,18
136,3,3,3,3,3,3,1,19,19
137,3,3,3,3,3,2,1,18,18
138,3,3,3,3,3,2,1,18,18
139,1,3,1,3,2,1,1,12,12
140,3,3,2,3,2,2,1,16,16
141,3,3,3,3,3,2,2,19,19
142,3,3,3,3,3,2,1,18,18
143,3,3,3,3,3,3,0,18,18
144,3,3,3,2,3,3,2,19,19
146,3,3,3,3,3,3,1,19,19
148,3,3,3,1,2,2,1,15,15
149,3,3,3,3,3,2,0,17,17
150,3,3,3,3,3,3,1,19,19
151,3,4,3,3,3,3,0,19,19
152,2,3,3,3,3,1,1,16,16
153,3,4,3,3,3,3,1,20,20
154,3,3,3,2,2,2,1,16,16
155,3,4,3,3,3,3,2,21,21
156,3,3,3,3,3,3,1,19,19
157,3,3,2,3,3,2,1,17,17
158,3,3,3,3,3,3,1,19,19
159,2,3,2,3,3,1,1,15,15
161,3,4,4,3,3,3,1,21,21
162,3,3,3,3,3,3,2,20,20
163,3,4,3,3,3,3,1,20,20
164,3,3,3,3,3,3,1,19,19
165,2,3,2,3,3,2,1,16,16
166,3,3,3,3,3,2,2,19,19
167,3,3,3,3,3,2,2,19,19
168,2,3,3,1,2,3,1,15,15
169,3,3,3,3,3,2,1,18,18
170,3,3,2,2,2,2,1,15,15
171,3,3,3,3,3,2,1,18,18
172,3,3,3,3,3,2,2,19,19
173,3,3,3,3,3,2,2,19,19
174,3,3,3,3,3,2,0,17,17
176,3,4,3,3,3,3,0,19,19
177,3,3,3,2,3,1,0,15,15
178,3,4,3,3,3,3,0,19,19
179,3,3,2,3,3,2,1,17,17
180,3,3,3,2,3,3,0,17,17
181,3,3,3,2,3,3,0,17,17
182,3,3,3,3,3,2,1,18,18
183,3,4,3,3,3,3,0,19,19
184,3,3,3,3,3,3,1,19,19
185,3,4,3,3,3,3,0,19,19
186,2,3,3,3,3,3,2,19,19
187,3,3,3,2,3,3,1,18,18
188,3,3,3,3,3,2,1,18,18
190,3,3,3,3,3,3,0,18,18
191,3,3,3,3,3,2,1,18,18
192,3,4,4,3,3,3,2,22,22
194,3,3,3,3,3,2,1,18,18
195,3,3,3,3,3,2,1,18,18
196,3,3,3,3,3,3,1,19,19
197,3,3,2,2,2,2,1,15,15
199,3,3,2,3,3,2,1,17,17
200,3,3,3,3,3,3,1,19,19
201,3,3,3,3,3,2,2,19,19
202,3,3,3,3,3,2,1,18,18
204,2,3,2,3,3,2,1,16,16
205,3,4,3,3,3,3,0,19,19
206,3,3,3,2,3,3,2,19,19
208,3,4,3,3,3,3,0,19,19
211,3,4,3,3,3,3,1,20,20
216,3,4,3,2,3,3,2,20,20
217,3,3,3,3,3,2,2,19,19
218,3,3,3,3,3,2,1,18,18
220,3,4,3,3,3,3,0,19,19
221,3,4,3,3,3,3,1,20,20
222,3,4,3,3,3,3,0,19,19
