essay_id,organization,vocabulary,style,development,mechanics,structure,relevance,final_score,total_score
1,4,4,4,4,4,4,2,28,26
3,4,4,4,4,4,4,2,26,26
4,5,4,4,4,4,5,2,28,28
5,4,4,4,4,4,4,2,28,26
6,4,4,4,4,4,4,2,26,26
7,4,4,4,4,4,4,2,28,26
8,4,4,4,4,4,4,2,28,26
9,4,4,4,4,4,4,2,28,26
10,4,4,4,4,4,4,2,26,26
11,4,4,4,4,4,4,2,26,26
12,4,4,4,4,4,4,2,28,26
13,4,4,4,4,4,4,2,26,26
14,4,4,4,4,4,4,2,28,26
15,4,4,4,4,4,4,2,26,26
16,4,4,4,4,4,4,2,26,26
17,4,4,4,4,4,4,2,26,26
18,4,4,4,4,4,4,2,26,26
19,4,4,4,4,4,4,2,26,26
20,4,4,4,4,4,4,2,26,26
21,4,4,4,4,4,4,2,28,26
22,4,4,4,4,4,4,2,26,26
23,4,4,4,4,4,4,2,26,26
24,4,4,4,4,4,4,2,26,26
25,4,4,4,4,4,4,2,26,26
26,4,4,4,4,4,4,2,26,26
27,4,4,4,4,4,4,2,26,26
28,4,4,4,4,4,4,2,26,26
29,4,4,4,4,4,4,2,26,26
31,4,4,4,4,4,4,2,26,26
32,4,4,4,4,4,4,2,26,26
33,4,4,4,4,4,4,2,26,26
34,4,4,4,4,4,4,2,28,26
35,4,4,4,4,4,4,2,26,26
36,4,4,3,4,3,4,2,24,24
37,4,4,4,4,4,4,2,26,26
38,4,4,4,4,4,4,2,26,26
39,4,4,4,4,4,4,2,28,26
40,4,4,4,4,4,4,2,28,26
41,4,4,4,4,4,4,2,28,26
42,4,4,4,4,4,4,2,28,26
43,4,4,4,4,4,4,2,26,26
44,4,4,4,4,4,4,2,26,26
45,4,4,4,4,4,4,2,26,26
47,4,4,4,4,4,4,2,26,26
48,4,4,4,4,4,4,2,26,26
49,4,4,4,4,4,4,2,26,26
50,4,4,4,4,4,4,2,26,26
51,4,4,4,4,4,4,2,26,26
52,4,4,4,4,4,4,2,26,26
53,4,4,4,4,4,4,2,26,26
54,4,4,4,4,4,4,2,26,26
55,4,4,4,4,4,4,2,26,26
56,4,4,4,4,4,4,2,26,26
57,4,4,4,4,4,4,2,28,26
58,4,4,4,4,4,4,2,26,26
59,4,4,4,4,4,4,2,26,26
60,4,4,4,4,4,4,2,26,26
61,4,4,4,4,4,4,2,26,26
63,4,4,4,4,4,4,2,28,26
64,4,4,4,4,4,4,2,26,26
65,4,4,4,4,4,4,2,26,26
66,4,4,4,4,4,4,2,26,26
68,4,4,4,4,4,4,2,26,26
69,4,4,4,4,4,4,2,26,26
70,4,4,4,4,4,4,2,26,26
71,4,4,4,4,4,4,2,26,26
72,4,4,4,4,4,4,2,28,26
73,4,4,4,4,4,4,2,28,26
74,4,4,4,4,4,4,2,26,26
75,4,4,4,4,4,4,2,26,26
76,4,4,4,4,4,4,2,26,26
77,4,4,4,4,4,4,2,26,26
78,4,4,4,4,4,4,2,26,26
79,4,4,4,4,4,4,2,26,26
80,4,4,4,4,4,4,2,26,26
81,4,4,4,4,4,4,2,28,26
82,4,4,4,4,4,4,2,26,26
83,4,4,4,4,4,4,2,26,26
84,4,4,4,4,4,4,2,26,26
86,4,4,4,4,4,4,2,26,26
87,4,4,4,4,4,4,2,26,26
88,4,4,4,4,4,4,2,28,26
89,4,4,4,4,4,4,2,26,26
90,4,4,4,4,4,4,2,26,26
91,4,4,4,4,4,4,2,26,26
92,4,4,4,4,4,4,2,26,26
93,4,4,4,4,4,4,2,26,26
94,4,4,4,4,4,4,2,26,26
95,4,4,4,4,4,4,2,28,26
96,4,4,4,4,4,4,2,28,26
97,4,4,4,4,4,4,2,26,26
99,4,4,4,4,4,4,2,28,26
100,4,4,4,4,4,4,2,26,26
101,4,4,4,4,4,4,2,26,26
102,4,4,4,4,4,4,2,28,26
103,4,4,4,4,4,4,2,26,26
104,4,4,4,4,4,4,2,26,26
105,4,4,4,4,4,4,2,26,26
106,4,4,4,4,4,4,2,26,26
107,4,4,4,4,4,4,2,26,26
108,4,4,4,4,4,4,2,26,26
109,4,4,4,4,4,4,2,28,26
110,5,4,4,4,4,5,2,28,28
111,4,4,4,4,4,4,2,28,26
112,4,4,4,4,4,4,2,26,26
113,4,4,4,4,4,4,2,28,26
115,4,4,4,4,4,4,2,28,26
116,4,4,4,4,4,4,2,26,26
117,4,4,4,4,4,4,2,26,26
118,4,4,4,4,4,4,2,28,26
119,4,4,4,4,4,4,2,28,26
120,4,4,4,4,4,4,2,26,26
121,4,4,4,4,4,4,2,26,26
122,4,4,4,4,4,4,2,28,26
124,4,4,4,4,4,4,2,28,26
125,4,4,4,4,4,4,2,26,26
126,4,4,4,4,4,4,2,26,26
127,4,4,4,4,4,4,2,26,26
128,4,4,4,4,4,4,2,26,26
130,4,4,4,4,4,4,2,26,26
131,4,4,4,4,4,4,2,28,26
132,4,4,4,4,4,4,2,26,26
133,4,4,4,4,4,4,2,26,26
134,4,4,4,4,4,4,2,26,26
136,4,4,4,4,4,4,2,26,26
137,4,4,4,4,4,4,2,26,26
138,4,4,4,4,4,4,2,28,26
139,4,4,4,4,4,4,2,26,26
140,4,4,4,4,4,4,2,26,26
141,4,4,4,4,4,4,2,26,26
142,4,4,4,4,4,4,2,26,26
143,4,4,4,4,4,4,2,26,26
144,4,4,4,4,4,4,2,26,26
146,4,4,4,4,4,4,2,26,26
148,3,4,3,4,3,4,2,23,23
149,4,4,4,4,4,4,2,26,26
150,4,4,4,4,4,4,2,26,26
151,4,4,4,4,4,4,2,28,26
152,4,4,4,4,4,4,2,28,26
153,4,4,4,4,4,4,2,26,26
154,4,4,4,4,4,4,2,28,26
155,4,4,4,4,4,4,2,26,26
156,4,4,4,4,4,4,2,26,26
157,4,4,4,4,4,4,2,26,26
158,4,4,4,4,4,4,2,26,26
159,4,4,4,4,4,4,2,28,26
161,4,4,4,4,4,4,2,26,26
162,4,4,4,4,4,4,2,26,26
163,4,4,4,4,4,4,2,26,26
164,4,4,4,4,4,4,2,26,26
165,4,4,4,4,4,4,2,26,26
166,4,4,4,4,4,4,2,26,26
167,4,4,4,4,4,4,2,26,26
168,4,4,4,4,4,4,2,26,26
169,4,4,4,4,4,4,2,26,26
170,4,4,4,4,4,4,2,26,26
171,4,4,4,4,4,4,2,26,26
172,4,4,4,4,4,4,2,26,26
173,4,4,4,4,4,4,2,28,26
174,4,4,4,4,3,4,2,25,25
176,4,4,4,4,4,4,2,26,26
177,4,4,4,4,4,4,2,26,26
178,4,4,4,4,4,4,2,26,26
179,4,4,4,4,4,4,2,26,26
180,4,4,4,4,4,4,2,28,26
181,4,4,4,4,4,4,2,26,26
182,4,4,4,4,4,4,2,28,26
183,4,4,4,4,4,4,2,26,26
184,4,4,4,4,4,4,2,26,26
185,4,4,4,4,4,4,2,26,26
186,4,4,4,4,4,4,2,28,26
187,4,4,4,4,4,4,2,26,26
188,4,4,4,4,4,4,2,26,26
190,4,4,4,4,4,4,2,26,26
191,4,4,4,4,4,4,2,26,26
192,5,4,4,4,4,5,2,28,28
194,4,4,4,4,4,4,2,26,26
195,4,4,4,4,4,4,2,28,26
196,4,4,4,4,4,4,2,26,26
197,4,4,4,4,4,4,2,26,26
199,4,4,4,4,4,4,2,26,26
200,4,4,4,4,4,4,2,26,26
201,4,4,4,4,4,4,2,26,26
202,4,4,4,4,4,4,2,26,26
204,4,4,4,4,4,4,2,26,26
205,4,4,4,4,4,4,2,26,26
206,4,4,4,4,4,4,2,26,26
208,4,4,4,4,4,4,2,26,26
211,4,4,4,4,4,4,2,26,26
216,4,4,4,4,4,4,2,26,26
217,4,4,4,4,4,4,2,26,26
218,4,4,4,4,4,4,2,26,26
220,4,4,4,4,4,4,2,28,26
221,4,4,4,4,4,4,2,28,26
222,4,4,4,4,4,4,2,28,26
