essay_id,rater_A,rater_B,rater_C,rater_D,rater_E,organization,vocabulary,style,development,mechanics,structure,relevance,final_score,total_score
1,4,4,4,4,4,4,4,4,4,4,4,2,26,26
3,5,4,4,5,4,4,4,4,4,4,4,2,26,26
4,4,4,4,4,4,4,4,4,4,4,4,2,26,26
5,5,4,4,5,5,4,4,4,4,4,4,2,26,26
6,5,4,4,4,4,4,4,4,4,4,4,2,26,26
7,5,5,5,5,5,5,5,5,5,5,5,2,32,32
8,4,4,4,4,4,4,4,4,4,4,4,2,26,26
9,4,4,5,5,4,4,4,4,4,5,4,2,27,27
10,4,4,4,4,4,4,4,4,4,4,4,2,26,26
11,4,4,4,5,4,4,4,4,4,4,4,2,26,26
12,5,4,4,4,4,4,4,4,4,4,4,2,26,26
13,4,4,4,4,4,4,4,4,4,4,4,2,26,26
14,4,4,4,4,4,4,4,4,4,4,4,2,26,26
15,4,4,4,4,4,4,4,4,4,4,4,2,26,26
16,4,4,4,4,4,4,4,4,4,4,4,2,26,26
17,4,4,4,4,4,4,4,4,4,4,4,2,26,26
18,4,5,4,5,5,4,4,4,4,4,4,2,26,26
19,4,4,4,4,4,4,4,4,4,4,4,2,26,26
20,4,4,4,4,4,4,4,4,4,4,4,2,26,26
21,4,4,4,4,4,4,4,4,4,4,4,2,26,26
22,4,4,4,4,4,4,4,4,4,4,4,2,26,26
23,4,4,4,4,4,4,4,4,4,4,4,2,26,26
24,4,4,4,4,4,4,4,4,4,4,4,2,26,26
25,5,4,4,5,4,4,4,4,4,4,4,2,26,26
26,4,4,4,4,4,4,4,4,4,4,4,2,26,26
27,4,4,4,4,4,4,4,4,4,4,4,2,26,26
28,4,4,4,4,4,4,4,4,4,4,4,2,26,26
29,4,4,4,4,4,4,4,4,4,4,4,2,26,26
31,5,5,5,5,5,5,5,5,5,5,5,2,32,32
32,4,4,4,4,4,4,4,4,4,4,4,2,26,26
33,4,5,4,5,5,4,4,4,4,4,4,2,26,26
34,5,5,4,5,4,4,4,4,5,4,4,2,27,27
35,5,5,5,5,5,5,5,5,5,5,5,2,32,32
36,4,4,4,4,4,4,4,4,4,4,4,2,26,26
37,4,4,4,4,4,4,4,4,4,4,4,2,26,26
38,4,4,4,4,4,4,4,4,4,4,4,2,26,26
39,5,5,5,5,5,5,5,5,5,5,5,2,32,32
40,4,4,4,4,4,4,4,4,4,4,4,2,26,26
41,4,4,4,4,4,4,4,4,4,4,4,2,26,26
42,4,4,4,4,4,4,4,4,4,4,4,2,26,26
43,4,4,4,4,4,4,4,4,4,4,4,2,26,26
44,4,4,4,4,4,4,4,4,4,4,4,2,26,26
45,4,4,4,4,4,4,4,4,4,4,4,2,26,26
47,4,4,4,4,4,4,4,4,4,4,4,2,26,26
48,4,4,4,5,4,4,4,4,4,4,4,2,26,26
49,4,4,4,4,4,4,4,4,4,4,4,2,26,26
50,4,4,4,4,4,4,4,4,4,4,4,2,26,26
51,5,5,5,5,5,5,5,5,5,5,5,2,32,32
52,4,4,4,4,4,4,4,4,4,4,4,2,26,26
53,4,4,4,5,4,4,4,4,4,4,4,2,26,26
54,4,4,4,4,4,4,4,4,4,4,4,2,26,26
55,4,4,4,4,4,4,4,4,4,4,4,2,26,26
56,5,4,5,5,5,5,4,4,4,5,4,2,28,28
57,5,4,4,4,4,4,4,4,4,4,4,2,26,26
58,5,5,5,5,5,5,5,5,5,5,5,2,32,32
59,4,4,4,4,4,4,4,4,4,4,4,2,26,26
60,4,4,4,4,4,4,4,4,4,4,4,2,26,26
61,4,4,3,4,4,3,3,3,4,3,3,2,21,21
63,5,5,5,5,5,5,5,5,5,5,5,2,32,32
64,4,4,5,4,4,4,4,4,4,5,4,2,27,27
65,5,5,5,5,5,5,5,5,5,5,5,2,32,32
66,4,4,5,5,4,4,4,4,4,5,4,2,27,27
68,4,4,4,4,4,4,4,4,4,4,4,2,26,26
69,4,4,4,4,4,4,4,4,4,4,4,2,26,26
70,5,5,5,5,5,5,5,5,5,5,5,2,32,32
71,4,4,4,4,4,4,4,4,4,4,4,2,26,26
72,4,4,4,4,4,4,4,4,4,4,4,2,26,26
73,4,4,4,4,4,4,4,4,4,4,4,2,26,26
74,4,4,4,4,4,4,4,4,4,4,4,2,26,26
75,4,4,4,4,4,4,4,4,4,4,4,2,26,26
76,4,4,4,4,4,4,4,4,4,4,4,2,26,26
77,5,4,4,4,4,4,4,4,4,4,4,2,26,26
78,4,4,4,4,4,4,4,4,4,4,4,2,26,26
79,4,4,4,4,4,4,4,4,4,4,4,2,26,26
80,4,4,4,4,4,4,4,4,4,4,4,2,26,26
81,4,4,4,4,4,4,4,4,4,4,4,2,26,26
82,5,5,5,5,5,5,5,5,5,5,5,2,32,32
83,4,4,4,4,4,4,4,4,4,4,4,2,26,26
84,4,4,4,4,4,4,4,4,4,4,4,2,26,26
86,4,5,4,5,5,4,4,4,4,4,4,2,26,26
87,4,4,4,4,4,4,4,4,4,4,4,2,26,26
88,4,4,5,5,4,4,4,4,4,5,4,2,27,27
89,5,4,4,4,4,4,4,4,4,4,4,2,26,26
90,5,5,5,5,5,5,5,5,5,5,5,2,32,32
91,4,4,4,4,4,4,4,4,4,4,4,2,26,26
92,4,4,4,4,4,4,4,4,4,4,4,2,26,26
93,4,4,4,4,4,4,4,4,4,4,4,2,26,26
94,4,4,4,4,4,4,4,4,4,4,4,2,26,26
95,0,0,0,0,0,0,0,0,0,0,0,0,0,0
96,5,4,4,4,4,4,4,4,4,4,4,2,26,26
97,4,4,4,4,4,4,4,4,4,4,4,2,26,26
99,4,4,4,4,4,4,4,4,4,4,4,2,26,26
100,4,4,4,4,4,4,4,4,4,4,4,2,26,26
101,4,3,4,4,3,4,3,3,3,4,3,1,21,21
102,5,4,4,4,4,4,4,4,4,4,4,2,26,26
103,4,4,4,4,4,4,4,4,4,4,4,2,26,26
104,5,5,5,5,5,5,5,5,5,5,5,2,32,32
105,4,4,4,4,4,4,4,4,4,4,4,2,26,26
106,0,0,0,0,0,0,0,0,0,0,0,0,0,0
107,4,4,4,4,4,4,4,4,4,4,4,2,26,26
108,4,4,4,4,4,4,4,4,4,4,4,2,26,26
109,4,4,4,4,4,4,4,4,4,4,4,2,26,26
110,5,5,5,5,5,5,5,5,5,5,5,2,32,32
111,4,4,4,4,4,4,4,4,4,4,4,2,26,26
112,4,4,4,4,4,4,4,4,4,4,4,2,26,26
113,4,4,4,5,4,4,4,4,4,4,4,2,26,26
115,4,4,4,4,4,4,4,4,4,4,4,2,26,26
116,4,4,4,4,4,4,4,4,4,4,4,2,26,26
117,4,4,4,4,4,4,4,4,4,4,4,2,26,26
118,5,5,5,5,5,5,5,5,5,5,5,2,32,32
119,0,0,0,0,0,0,0,0,0,0,0,0,0,0
120,4,4,4,4,4,4,4,4,4,4,4,2,26,26
121,4,4,4,4,4,4,4,4,4,4,4,2,26,26
122,4,4,4,4,4,4,4,4,4,4,4,2,26,26
124,4,4,4,4,4,4,4,4,4,4,4,2,26,26
125,4,4,4,4,4,4,4,4,4,4,4,2,26,26
126,4,4,4,4,4,4,4,4,4,4,4,2,26,26
127,4,4,4,4,4,4,4,4,4,4,4,2,26,26
128,5,4,4,4,4,4,4,4,4,4,4,2,26,26
130,4,4,4,4,4,4,4,4,4,4,4,2,26,26
131,4,4,4,4,0,4,2,2,4,4,4,1,21,21
132,4,4,4,4,4,4,4,4,4,4,4,2,26,26
133,5,4,4,4,4,4,4,4,4,4,4,2,26,26
134,4,4,4,4,4,4,4,4,4,4,4,2,26,26
136,4,4,4,4,4,4,4,4,4,4,4,2,26,26
137,4,4,4,4,4,4,4,4,4,4,4,2,26,26
138,4,4,4,4,4,4,4,4,4,4,4,2,26,26
139,4,4,4,4,4,4,4,4,4,4,4,2,26,26
140,4,4,4,4,4,4,4,4,4,4,4,2,26,26
141,4,4,4,4,4,4,4,4,4,4,4,2,26,26
142,5,5,5,5,5,5,5,5,5,5,5,2,32,32
143,4,4,4,4,4,4,4,4,4,4,4,2,26,26
144,5,5,5,5,5,5,5,5,5,5,5,2,32,32
146,4,4,4,4,4,4,4,4,4,4,4,2,26,26
148,4,4,4,4,4,4,4,4,4,4,4,2,26,26
149,5,4,4,4,4,4,4,4,4,4,4,2,26,26
150,4,4,4,4,4,4,4,4,4,4,4,2,26,26
151,5,5,5,5,5,5,5,5,5,5,5,2,32,32
152,5,4,4,5,4,4,4,4,4,4,4,2,26,26
153,4,5,4,5,4,4,4,4,4,4,4,2,26,26
154,4,4,4,4,4,4,4,4,4,4,4,2,26,26
155,5,5,5,5,5,5,5,5,5,5,5,2,32,32
156,4,4,4,4,0,4,2,2,4,4,4,1,21,21
157,4,4,4,5,4,4,4,4,4,4,4,2,26,26
158,4,4,4,4,4,4,4,4,4,4,4,2,26,26
159,5,5,5,5,5,5,5,5,5,5,5,2,32,32
161,4,4,4,4,4,4,4,4,4,4,4,2,26,26
162,0,0,0,0,0,0,0,0,0,0,0,0,0,0
163,5,5,4,4,4,4,4,4,4,4,4,2,26,26
164,5,5,5,5,5,5,5,5,5,5,5,2,32,32
165,4,4,3,4,3,3,3,3,4,3,3,1,20,20
166,4,4,4,4,4,4,4,4,4,4,4,2,26,26
167,4,4,4,5,4,4,4,4,4,4,4,2,26,26
168,4,4,4,4,4,4,4,4,4,4,4,2,26,26
169,4,4,4,4,4,4,4,4,4,4,4,2,26,26
170,4,4,3,3,3,3,3,3,3,3,3,1,19,19
171,4,4,4,4,4,4,4,4,4,4,4,2,26,26
172,4,4,4,4,3,4,3,3,4,4,4,1,23,23
173,0,0,0,0,0,0,0,0,0,0,0,0,0,0
174,4,4,4,4,4,4,4,4,4,4,4,2,26,26
176,5,4,4,4,4,4,4,4,4,4,4,2,26,26
177,5,5,5,5,5,5,5,5,5,5,5,2,32,32
178,5,5,5,5,5,5,5,5,5,5,5,2,32,32
179,4,4,4,4,4,4,4,4,4,4,4,2,26,26
180,4,4,4,4,4,4,4,4,4,4,4,2,26,26
181,5,5,5,5,5,5,5,5,5,5,5,2,32,32
182,4,4,4,4,4,4,4,4,4,4,4,2,26,26
183,4,5,4,5,5,4,4,4,4,4,4,2,26,26
184,4,4,4,4,4,4,4,4,4,4,4,2,26,26
185,4,4,4,4,4,4,4,4,4,4,4,2,26,26
186,4,4,4,4,4,4,4,4,4,4,4,2,26,26
187,0,0,0,0,0,0,0,0,0,0,0,0,0,0
188,4,4,4,4,4,4,4,4,4,4,4,2,26,26
190,4,5,4,5,4,4,4,4,4,4,4,2,26,26
191,4,4,4,4,4,4,4,4,4,4,4,2,26,26
192,4,4,4,4,4,4,4,4,4,4,4,2,26,26
194,4,4,4,4,4,4,4,4,4,4,4,2,26,26
195,0,0,0,0,0,0,0,0,0,0,0,0,0,0
196,4,4,4,4,4,4,4,4,4,4,4,2,26,26
197,4,4,4,4,4,4,4,4,4,4,4,2,26,26
199,4,4,4,4,4,4,4,4,4,4,4,2,26,26
200,4,4,4,4,4,4,4,4,4,4,4,2,26,26
201,4,4,4,4,4,4,4,4,4,4,4,2,26,26
202,4,4,4,4,4,4,4,4,4,4,4,2,26,26
204,4,4,4,4,4,4,4,4,4,4,4,2,26,26
205,4,4,4,4,4,4,4,4,4,4,4,2,26,26
206,4,4,4,4,4,4,4,4,4,4,4,2,26,26
208,4,4,4,4,4,4,4,4,4,4,4,2,26,26
211,4,4,4,5,4,4,4,4,4,4,4,2,26,26
216,5,4,5,4,4,4,4,4,4,5,4,2,27,27
217,5,5,5,5,5,5,5,5,5,5,5,2,32,32
218,5,4,4,4,4,4,4,4,4,4,4,2,26,26
220,4,4,4,4,4,4,4,4,4,4,4,2,26,26
221,5,4,4,4,4,4,4,4,4,4,4,2,26,26
222,4,4,4,4,4,4,4,4,4,4,4,2,26,26
